10 14 9 1
1 1 1 0 0 0 0 0 1 1 1 1 1 1
1 9 1 0 0 1 0 0 1 1 1 1 7 1
1 1 1 0 0 0 0 0 1 1 1 1 0 0
0 0 0 0 0 0 0 0 0 1 1 1 0 0
0 0 0 0 0 0 0 0 0 0 0 1 1 0
0 0 0 0 0 0 0 0 0 0 0 0 1 0
0 0 0 0 0 0 0 0 0 0 0 0 1 0
0 0 0 0 0 0 0 0 0 0 0 1 1 0
0 0 0 0 1 1 1 1 1 0 0 1 1 0
0 0 0 0 1 5 0 0 1 1 1 3 1 0
12 1 2 1 12 1 9
11 9 4 1 6 1 7 2 12 3 12
5 9 2 1 3 1 4
