10 15 1 8
0 0 0 0 0 0 0 1 1 1 0 0 1 1 1
0 0 0 0 1 1 1 1 1 1 0 0 3 1 1
1 1 0 0 1 0 0 1 1 1 0 0 1 1 1
1 1 1 1 1 0 0 0 5 0 0 0 0 0 0
1 1 0 0 0 0 0 0 0 0 0 0 0 0 0
0 1 0 0 0 0 0 7 0 0 0 0 0 0 0
0 1 0 0 0 0 0 1 0 0 0 0 0 0 0
1 1 1 0 0 0 1 1 1 0 0 4 1 1 0
1 1 1 1 1 1 1 1 1 1 1 1 9 1 0
1 1 1 0 0 0 1 1 1 0 0 4 1 1 0
7 5 2 8 1 1 13
11 7 2 8 9 8 10
11 9 2 8 9 8 10
8 3 4 1 5 1 6 1 10 1 11
12 1 4 1 5 1 6 2 2 2 3
