8 14 1 2
0 0 0 0 0 0 0 0 0 0 1 1 1 1
0 0 0 0 1 1 1 1 1 1 1 3 1 7 
0 1 0 0 1 3 1 0 0 0 1 1 1 1
3 1 0 0 1 1 0 0 0 0 0 0 1 0 
1 1 0 0 1 0 0 0 0 0 0 0 1 0 
1 1 1 1 1 0 0 0 0 0 1 1 1 0
1 1 1 0 0 1 1 1 0 0 1 9 1 0 
0 0 0 0 0 3 1 0 0 0 1 1 1 0
0 3 0 0 1 1 3
11 1 0 0 2 2 2 2 3
5 2 0 0 1 7 7
13 1 2 6 5 6 7
5 7 0 0 2 6 8 6 9
